le lien :: link (website)
le fureteur :: (web) browser
piger :: to try your luck (tirer au sort)
tirer au sort :: to draw straws, to try your luck (piger)
l'avoine (f) :: oat(s)
les jeux de société :: games (board, card) played with a group
le traineau à chiens :: dog sledding
muet :: silent
épeler :: to spell
la tablette de chocolat :: chocolate bar (idiom: six-pack abs)
ronfler :: to snore
la planche à neige :: snowboarding
accrocher :: to hook
le crochet :: hook
être accro à (q.q.c.) :: be hooked on something
mou :: soft
le chlore :: chlorine
guérir :: to cure
démolir :: to demolish
saler :: to salt
le sol :: floor
s'évanouir :: faint
tomber dans les pommes :: faint (idiom)
un chat dans la gorge :: frog in the throat (idiom)
deviner :: guess
se détendre :: to relax
être à l'aise (avec ...) :: to be at ease
confortable :: comfortable (only to describe things)
se déguiser :: to disguise (yourself)
jouer à cache-cache :: to play hide and seek
le point de suture :: stitch (medical)
une échéance :: expiration (both as in "expiration date" and breathing out)
cueillir :: to pick (fruit, flower, etc.)
mûrir :: to ripen
foncé :: bright (as in color)
la virgule :: comma
niaiser :: say stupid or false things
congés payés :: paid vacation
démissioner :: to resign
licencier :: to fire
le stagiaire :: intern
le stage :: internship
coudre :: to sew
peler :: to peel
dépasser :: go beyond, over (in the sense of a limit)
reporter :: postpone
réseau :: network
décrocher :: pick up (the phone)
raccrocher :: hang up (the phone)
l'ébeniste (m) :: furniture maker (wood), cabinet maker
le menuisier :: carpenter
le cadre (sens q.q.u.) :: executive
le chômage :: unemployment
